0	77	-117	-37	51	15	-65	15
-77	0	30	124	-30	-307	122	102
117	-30	0	26	318	-258	-185	58
37	-124	-26	0	189	-6	-63	-99
-51	30	-318	-189	0	248	33	114
-15	307	258	6	-248	0	-160	-168
65	-122	185	63	-33	160	0	-318
-15	-102	-58	99	-114	168	318	0