0	12	19	21	22	14	22	5
12	0	38	24	7	21	11	10
19	38	0	38	13	10	19	4
21	24	38	0	22	5	16	40
22	7	13	22	0	34	27	17
14	21	10	5	34	0	23	38
22	11	19	16	27	23	0	22
5	10	4	40	17	38	22	0